0 3 9 3 3 3 3
0 3 9 3 3 3 3
0 3 9 3 3 3 3
0 3 9 3 3 3 3
0 4 9 3 3 3 3
0 3 9 3 3 3 3
1 9 3 3 3 3 3
0 3 3 3 3 3 3
0 3 3 3 3 9 3
0 3 3 3 3 9 3
0 3 9 3 3 3 3
0 3 6 3 3 3 3
0 3 9 3 3 3 3
0 3 4 3 3 3 3
0 3 9 3 3 3 3
2 3 3 9 3 3 3
2 3 3 9 3 3 3
0 3 9 3 3 3 3
0 3 9 3 8 3 3
0 3 9 3 3 3 3
0 9 5 3 3 3 3
0 3 9 3 3 3 3
0 3 9 3 3 3 3
0 3 9 3 3 3 3
0 3 9 3 3 3 3
0 3 9 3 3 3 3
0 3 9 3 3 3 3
0 3 9 3 3 3 3
0 4 9 3 3 3 3
0 3 9 3 3 3 3
1 9 3 3 3 3 3
0 3 3 3 3 3 3
0 3 3 3 3 9 3
3 3 3 3 3 9 3
0 3 9 3 3 3 3
0 3 6 3 3 3 3
0 3 9 3 3 3 3
0 3 4 3 3 3 3
0 3 9 3 3 3 3
2 3 3 9 3 3 3
2 3 3 9 3 3 3
0 4 4 9 3 3 3
0 3 9 3 8 3 3
0 3 9 3 3 3 3
0 9 5 3 3 3 3
0 3 9 3 3 3 3
0 3 9 3 3 3 3
0 3 9 3 3 3 3
